2222222222;
2011111112;
2121112212;
2111222242;
2141111122;
2111111112;
2122111112;
2122112112;
2114123112;
2222222222