22222222222;
21421112232;
21114112112;
21211012122;
21222222112;
21114111112;
22222222222